1111111111
1000000001
1000000001
1000000001
1000000001
1000000001
1000PC0E01
1000000001
1000000001
1111111111
