1111111111
1000000001
100000C001
10C0000001
1000000001
1000000001
1000000E01
10000C0001
100P0000C1
1111111111
