1111111111
10000000P1
1000000001
1000000001
1000000001
1000000001
1000000001
1000000001
1000000001
1111111111
