111111111111111
100000000001111
100000000100001
100000000000001
100000000000001
100000000000001
100000100000001
100000000000001
100000000000001
100000000000001
100000000000001
100000000000001
100000000000001
10P000000000001
111111111111111
