11111
000C1
1P001
1CC11
11111
