11111
000C1
11001
10011
11111
