11111
000C1
1P001
10011
11111
