11111
100C1
1P001
10011
11111
