11111111111111111111
1000100E0C0C1C0000P1
10001000000010000001
10001000000011111101
10001000000000000001
10001000000000000001
10000000000000000001
10001100000000000001
10001000000000000001
10011111110000000001
11110011100000000001
10000010000000000001
10111110100000000001
10000000101000000001
11111111111111111111