11111111111111111111
1000000E0C0C0C0000P1
10000000000000000111
11111111111111111111