111011111111111111111
10000000000E0CCC0P11
10000000000000000111
11111111111111111111