111111111111
1111111111P1
11C000011101
1101110C00C1
11000000E011
111111111111